en:

coup - Create a game of Coup
snitch - Create a game of Snitch
letter - Create a game of Love Letter
zombie - Create a game of Zombie Dice
superfight - Create a game of Superfight
join - Join an existing game or create a new one
start - Start an existing game
cancel - Cancel an existing game
help - Show a summary of the rules

eo:

pucxo - Krei ludon de Puĉo
perfidulo - Krei ludon de Perfidulo
amletero - Krei ludon de Amletero
zombio - Krei ludon de Zombiaj Kuboj
superbatalo - Krei ludon de Superbatalo
aligxi - Aligxi al jam kreita ludo
komenci - Komenci jam kreitan ludon
nuligi - Nuligi jam kreitan ludon
helpo - Montri resumon de la reguloj

fr:

complot - Créer un jeu de Complot
balance - Créer un jeu de Balance
letter - Créer un jeu de Love Letter
rejoindre - Rejoindre un jeu déjà créé
commencer - Commencer un jeu
annuler - Annuler un jeu
aide - Montrer un résumé des règles

pt-br:

golpe - Criar um jogo de Golpe
informante - Criar um jogo de Informante
carta - Criar um jogo de Carta de amor
zumbi - Criar um jogo de Dado Zumbi
entrar - Entrar um jogo existente ou criae um novo
iniciar - Iniciar um jogo existente
cancelar - Cancelar um jogo
ajuda - Mostrar um resumo das regras
